F 251,100,0
C 224,60,42
NO ./path_to_the_north_texture.xpm
SO ./path_to_the_south_texture.xpm
WE ./path_to_the_west_texture.xpm
EA ./path_to_the_east_texture.xpm



111111111111111111111111111111111
111111111011000001110000000000001
100000000011000001110111111111111
11110111111111011100000010001
11110111111111011101010010001
11000000110101011100000010001
10000000000000001100000010001
10000000000000001101010010001
1000001110101011111011110N0111
11110111 1110101 101111010001
11111111 1111111 111111111111
